21 21
0 1
20 19
H HHHHHHHHHHHHHHHHHHH
H H         H       H
H H HHHHHHH HHHHH H H
H   H     H     H H H
H HHH HHH HHHHH H H H
H H   H     H   H H H
H H HHH HHH H HHH HHH
H H H H   H H H H   H
H H H HHH H H H H H H
H H   H   H H   H H H
H HHH H HHH HHHHHHH H
H   H H H         H H
HHH HHH HHHHHHHHH H H
H H   H H   H   H H H
H HHH H H H H H H H H
H   H H   H H H H   H
H HHH HHHHH HHH HHH H
H     H   H   H     H
H HHHHH H HHH H HHHHH
H       H     H     H
HHHHHHHHHHHHHHHHHHH H

