15 15
0 1
14 13
H HHHHHHHHHHHHH
H             H
HHHHHHHHHHH H H
H   H   H   H H
H H H H H HHH H
H H   H H H   H
H HHHHH H HHH H
H H H   H   H H
H H H HHH H H H
H H   H   H H H
H HHH HHHHH H H
H H H       H H
H H HHHHHHHHH H
H   H         H
HHHHHHHHHHHHH H

